0,0,0,0,0,0,0,0,0,0,0,0,0,0,0,0
0,0,0,0,0,0,0,0,0,0,0,0,0,0,0,20
0,0,0,0,0,0,0,0,0,0,0,0,0,0,0,0
0,0,6,11,11,11,11,11,11,11,11,11,11,11,11,11
0,0,10,14,14,14,14,14,14,14,14,14,14,14,14,14
0,0,10,14,14,14,14,14,14,14,14,14,14,14,14,14
0,0,10,14,14,14,14,14,14,14,14,14,14,14,14,14
0,0,10,14,14,14,14,14,14,14,14,14,14,14,14,14
0,0,9,13,13,13,13,13,13,13,13,13,13,13,13,13
0,0,0,0,0,0,0,0,0,0,0,0,0,0,0,0
0,0,0,0,0,0,0,0,0,0,0,0,0,0,0,15
0,0,0,0,0,0,0,0,0,0,0,0,0,0,0,0
