0,0,0,21,0,0,21,0,0,21,0,0,0,0,0,0
0,20,0,21,0,0,21,0,0,21,0,6,7,0,15,0
0,0,0,21,0,0,4,0,0,21,0,10,12,0,0,0
0,0,0,21,0,0,0,0,0,21,0,10,12,0,0,0
0,0,0,21,0,0,0,0,0,21,0,9,8,0,0,0
0,0,0,4,0,0,2,0,0,21,0,0,0,0,0,0
0,0,0,0,0,0,21,0,0,21,0,0,0,0,0,0
0,0,0,0,0,0,21,0,0,4,0,6,7,0,0,0
0,0,0,2,0,0,21,0,0,0,0,10,12,0,0,0
0,0,0,21,0,0,21,0,0,0,0,10,12,0,0,0
0,0,0,21,0,0,21,0,0,2,0,9,8,0,0,0
0,0,0,21,0,0,21,0,0,21,0,0,0,0,0,0
