0,0,0,0,9,13,16,14,14,19,13,8,0,0,0,0
0,20,0,0,0,0,9,13,13,8,0,0,0,0,15,0
0,0,0,6,7,0,0,1,0,1,0,6,7,0,0,0
0,0,0,10,12,0,0,0,0,0,0,10,12,0,0,0
0,0,0,10,12,0,1,0,1,0,1,10,12,0,0,0
0,0,0,10,12,0,0,0,0,0,0,10,12,0,0,0
0,0,0,10,12,1,0,1,0,1,0,10,12,0,0,0
0,0,0,10,18,11,11,11,11,11,11,17,12,0,0,0
0,0,0,10,14,14,14,14,14,14,14,14,12,0,0,0
0,0,0,9,13,13,13,13,13,13,13,13,8,0,0,0
0,0,0,0,0,0,0,0,0,0,0,0,0,0,0,0
0,0,0,0,0,0,0,0,0,0,0,0,0,0,0,0
