0,20,0,0,0,0,0,0,0,0,0,0,0,0,0,0
0,0,0,0,0,0,0,0,0,0,0,0,0,0,0,0
22,22,22,22,22,22,3,0,0,5,22,22,22,22,22,22
0,0,0,0,0,0,0,0,0,0,0,0,0,0,0,0
0,0,5,22,22,22,22,22,22,22,22,22,22,3,0,0
0,2,0,0,0,0,0,0,0,0,0,0,0,0,2,0
0,4,0,0,0,5,3,0,0,5,3,0,0,0,4,0
0,0,0,0,2,0,0,0,0,0,0,2,0,0,0,0
0,2,0,0,21,0,0,6,7,0,0,21,0,0,2,0
0,21,0,0,21,0,0,9,8,0,0,21,0,0,21,0
0,21,0,0,21,0,0,0,0,0,0,21,0,0,21,0
0,21,0,0,21,0,0,0,15,0,0,21,0,0,21,0
