0,20,0,0,0,0,0,6,7,0,0,0,0,0,0,0
0,0,0,5,3,0,0,10,12,0,0,0,0,0,0,0
0,6,7,0,0,0,0,10,12,0,0,0,0,0,0,0
0,9,8,0,0,0,0,10,12,0,0,0,0,0,0,0
0,0,0,6,7,0,0,10,12,0,0,0,1,0,1,0
0,0,0,9,8,0,0,10,12,0,0,0,0,15,0,0
0,6,7,0,0,0,0,10,12,0,0,0,1,0,1,0
0,9,8,0,0,0,0,10,12,0,0,0,0,0,0,0
0,0,0,6,7,0,0,10,18,11,11,7,0,0,0,0
0,0,0,9,8,0,0,9,13,13,13,8,0,0,0,0
0,0,0,0,0,0,0,0,0,0,0,0,0,0,0,0
0,0,0,0,0,0,0,0,0,0,0,0,0,0,0,0
