0,0,9,8,0,0,0,9,16,14,14,14,12,0,0,0
0,0,0,0,0,0,0,0,9,16,14,14,12,0,0,0
0,0,0,0,6,7,0,0,0,9,16,14,12,0,0,0
0,0,6,11,17,18,7,0,0,0,9,16,12,0,0,0
0,0,10,14,14,14,18,7,0,0,0,9,8,0,0,0
0,20,10,14,14,14,14,12,0,0,0,0,0,0,0,15
0,0,10,14,14,14,19,8,0,0,0,6,7,0,0,0
0,0,9,13,16,19,8,0,0,0,6,17,12,0,0,0
0,0,0,0,9,8,0,0,0,6,17,14,12,0,0,0
0,0,0,0,0,0,0,0,6,17,14,14,12,0,0,0
0,0,6,7,0,0,0,6,17,14,14,14,12,0,0,0
0,0,10,12,0,0,6,17,14,14,14,14,12,0,0,0
