0,0,0,0,0,0,0,0,0,0,0,0,0,0,0,0
0,0,6,7,0,0,0,0,0,0,0,0,0,0,0,0
0,0,10,12,0,5,22,22,22,3,2,0,0,0,0,0
0,0,10,12,0,0,0,0,0,0,21,0,0,0,0,0
0,0,10,12,0,0,0,0,0,0,21,0,0,0,0,0
0,0,10,12,0,0,0,0,0,20,21,0,0,0,0,0
0,0,10,12,0,0,0,0,0,0,21,15,0,0,0,0
0,0,10,12,0,0,0,0,0,0,21,0,0,0,0,0
0,0,10,12,0,0,0,0,0,0,21,0,0,0,0,0
0,0,10,12,0,5,22,22,22,3,4,0,0,0,0,0
0,0,9,8,0,0,0,0,0,0,0,0,0,0,0,0
0,0,0,0,0,0,0,0,0,0,0,0,0,0,0,0
